CCCCCCCCCCCCCCCCCCCCCCCCCCCCCCCCCCCCCCCCCCCCCCCCCCCC                                                                                                                                                                                                                                                                                                              CCCCCCCCCCCCCCCCCCCCCCCCCCCCCCCCCCCCCCCCCCCCCCCCCCCCCCCCCCCCC
                                                   C                                                                                                                                                                                                                                                                                                              C                                                            
                                                   C                                                                                                                                                                                                                                                                                                              C                                                            
                                                   C                                                                                                                                                                                                                                                                                                              C                                                            
                                                   C                                                                                                                                                                                                                                                                                                              C                                                            
                                                   C                                                                                                                                                                                                                                               CCCCCCCCCCCCCCCCCCCCCCCCCCCCCCCCCCCCCCCCCCCCCCCCCCCCCCCCCCCCCCCC                                                            
                                                   C                                                                                                                                                                                                                                               C                                                                                                   X                       
                                                   C                                                                                                                                                                                                                                               C                                                                                                                           
                                                   CCCCCCCCCCCCCCCCCCCCCCCCCCCCCCC                                                                                                                                                                                                                 C                                                                                                                           
                                                                                 C                                                                                                                                                                                                                 C                                                                                                                           
                                                                                 C                                                                                                                                                                                                                 C                                                                                                                           
                                                                                 C                                                                                                                                                                                                                 C                                                                                                                           
                                                                                 C                                                                                                                                                                                                                 C                                                                 X                                             X           
                                                                                 C                                                                                                                                                     CCCCCCCCCCCCCCCCCCCCCCCCCCCCCCCCCCCCCCCCCCCCCCCCCCCCCCCCCCCCC                                                                                                                           
                                                                                 C                                                                                                                                                     C                                                                                  X                                                                                                    
                                                                                 C                                                                                                                                                     C                                                                                                                                                                                       
                   @                                              X              CCCCCCCCCCCCCCCCCCCCCCCCCCCCCCCCCCCCCCCCCCCCCCCCCCCCCCCCCCCCCCCCCCCCCCCCCCCCCCCCCCCCCCCCCCCCCCCCCCCCCCCCCCCCCCCCCCCCCCCCCCCCCCCCCCCCCCCCCCCCCCCCCCCCCCC                                                                                                                                                                                       
                                                                                                                                                                                                    CCCCCCCCCCCCCCCCCCCCCCCCCCCCCCCCCCCC         X                                                                                                                                                                             
                                                                                                                                                                                                    CCCCCCCCCCCCCCCCCCCCCCCCCCCCCCCCCCCC                                                                                                                                                                                       
                                                                                                                                                                                                    CCCCCCCCCCCCCCCCCCCCCCCCCCCCCCCCCCCC                                                                                                                                            X                                          
                                                                                                                X                                                                                                                                                                                                                                   X                                                                          
                                                                                                                                                                                                                        X                                                                              X                                                                                                                       
                                                                                                                                                                                   X                CCCCCCCCCCCCCCCCCCCCCCCCCCCCCCCCCCCC                         X                                                                                                                                                             
                                                             X                                                                                                                                      CCCCCCCCCCCCCCCCCCCCCCCCCCCCCCCCCCCC                                                                                                                                                                             X         
                                                                                                                                                                                                    CCCCCCCCCCCCCCCCCCCCCCCCCCCCCCCCCCCC                                                                                                                                                                                       
                                                                                                                                                                                                    CCCCCCCCCCCCCCCCCCCCCCCCCCCCCCCCCCCC                                                                                                                                                                                       
                                                                                                                                                                                                    CCCCCCCCCCCCCCCCCCCCCCCCCCCCCCCCCCCCCCCCCCCCCCCCCCCCCCCCCCCCCCCCCCCCCCCCCCCCCCCCCCCCCCCCCCCCCCCCCCCCCCCCCCCCCCCCCCCCCCCCCCCCCCCCCCCCCCCCCCCCCCCCCCCCCCCCCCCCCCCCCCCCCCCCCCCCCCCCCCCCCCCCCCCCCCCCCCCCCCCCCCCCCCCCCCCCCCCC   
                                          CCCCCCCCCCCCCCCCCCCCCCCCCCCCCCCCCCCCCCCCCCCCCCCCCCCCCCCCCCCCCCCCCCCCCCCCCCCCCCCCCCCCCCCCCCC           X                                                  C                                                                                                                                                                                                                        C  
                      X                  C                                                                                           C                                                             C                                                                                                                                                                                                                        C  
                                         C                                                                                           C                                      X                      C                                                                                                                                                                                                                        C  
                                         C                                                                                           C                                                             C                                                                                                                                                                                                                        C  
                                         C                                                                                           C                                                             C                                                                                                                                                                                                                        C  
                                         C                                                                                           C                                                             C                                                                                                                                                                                                                        C  
                                         C                                                                                           CCCCCCCCCCCCCCCCCCCCCCCCCCCCCCCCCCCCCCCCCCCCCCCCCCCCCCCCCCCCCCC                                                                                                                                                                                                                        C  
CCCCCCCCCCCCCCCCCCCCCCCCCCCCCCCCCCCCCCCCCC                                                                                                                                                                                                                                                                                                                                                                                  CCC